%%%%%%%%%%%%%%%%%%%%%%%%%%%%%%%%
%............%...........%.....%
%.%.%%.%.%%%.%.%%%..%%.%.%.%%%.%
%.%....%.%......%......%.....%.%
%...%.%%.%.%%%%.%.%.%%...%%%...%
%%%.%....%.%...   %..%.%...%.%%%
%.....%.%%.%.%%%G%%%.%.%%%.%...%
%.%%%.......... G .........%.%.%
%.%.%.%%%..%.%%%%%%%.%.%%%.%...%
%.%........%....%....%.%...%.%%%
%.%.%%%.%.%.%%%.%.%%%%.%.%%%...%
%.%.....%.......%......%.....%.%
%...%.%.%%%.%.%%%%%%.%%%.%.%%%.%
%.%...%.........P.....%........%
%%%%%%%%%%%%%%%%%%%%%%%%%%%%%%%%
