%%%%%%%%%%%%%%%%%%%%%%%%%%%%%%%%
%............%...........%.....%
%.%.%%.%.%%%.%.%%%..%%.%.%.%%%.%
%.%....%.%......%......%.....%.%
%...%.%%.%.%%%%.%.%.%%...%%%...%
%%%.%....%.%... % %..%.%...%.%%%
%.....%.%%.%.%%% %%%.%.%%%.%...%
%.%%%..........%G%.........%.%.%
%.%.%.%%%..%.%%%%%%%.%.%%%.%...%
%.%........%....%....%.%...%.%%%
%.%.%%%.%.%.%%%.%.%%%%.%.%%%...%
%.%.....%.......%......%.....%.%
%...%.%.%%%.%.%%%%%%.%%%.%.%%%.%
%.%...%.........P.....%........%
%%%%%%%%%%%%%%%%%%%%%%%%%%%%%%%%
