%%%%%%%%%%%%%%%%%%%%%%%%%%%%%%%%
%............%...........%.....%
%.%.%%.%.%%%.%.%%%..%%.%.%.%%%.%
%.%....%.%......%......%.....%.%
%...%.%%.%.%%%%.%.%.%%...%%%...%
%%%.%....%.%...   %..%.%...%.%%%
%...%.%.%%.%.%%% %%%.%.%%%.%...%
%.%.%.......... G .........%.%.%
%...%.%%%..%.%%%%%%%.%.%%%.%...%
%%%.%...%..%....%....%.%...%.%%%
%...%%%.%.%.%%%.%.%%%%.%.%%%...%
%.%%....%.......%......%.....%.%
%..%..%.%%%.%.%%%%%%.%%%.%.%%%.%
%.....%.........P.....%........%
%%%%%%%%%%%%%%%%%%%%%%%%%%%%%%%%
