%%%%%%%%%%%%%%%%%%%%%
%.      %          .%
% %   %  .%         %
%       %%     %    %
%         % %.      %
%    %   %P %       %
%     %      %      %
%           %.%     %
% %      %  %    %%%%
%.          %    %G %
%%%%%%%%%%%%%%%%%%%%%