%%%%%%%%%%%%%%%%%%%%%
%.                 .%
%        .%         %
%       %%     %    %
%            .      %
%    %    P         %
%     %             %
%           .       %
%        %       %%%%
%.               %G %
%%%%%%%%%%%%%%%%%%%%%