%%%%%%%%%%%%%%%%%%%%
%......%G  G%......%
%.%%...%%  %%...%%.%
%.%..%........%..%.%
%.%%.%.%%%%%%.%.%%.%
%........P.........%
%%%%%%%%%%%%%%%%%%%%
