%%%%%%
%..G.%
%..G.%
% %. %
%. ..%
%. % %
%.. .%
% %. %
%....%
% .% %
%. ..%
% % .%
%.  .%
% .% %
%P ..%
%%%%%%
